*********************************************************************
*********************************************************************
**s*       *                                                       **
** * ***** * ******* ********************************************* **
** *    *  * ******* **            *                             * **
** **** * ** *        * ********** * * ************************* * **
**      *      ****** * *          * * *                       * * **
****************      * * ********** * * ********************* * * **
**               ****** *            * * *                 *** * * **
** ***************      ************** * * ***************   * * * **
** *               ******            *   *           *   *** * * * **
** * ***************    * ********** *************** * *     * * * **
** * *      *        ** *          *               * * ******* * * **
** * * **** * ********* ********** ***************   *         * * **
** * *    * * *       * **********                ************** * **
** * **** * * * ***** * *          * ************   *          * * **
** * * ** * * * *     * * ********** *          * * ******** * * * **
** * * **       * ***** * *   ****** * ******** * * *        * * * **
** * * ** ******* *   * * * *        * *      * * * * ******** * * **
** * * ** *       * * * * * ********** * * ** * * * * *        * * **
** * * ** * ******* * * * *            * * ** * * * * ******** * * **
** * * ** * *       * * * ******* * **** * ** * * * *        * * * **
** * * ** * * ******* * *         *      * ** *   * ******** * * * **
** * * ** *   ******* * ****************** ** *****          * * * **
** * * ********       * ****************** ** **************** * * **
** * *          *******                                        *   **
** * * **************************************************************
**   *                                                            e**
*********************************************************************
*********************************************************************